SO ./texter/wall.xpm
NO ./texter/empty.xpm
WE ./texter/player.xpm
EA ./texter/empty.xpm

F 220,100,0
C 225,30,0



1111111111111111111111111
1000000000000000000000001
1000000000000000000000001
1000000000000000000000001
1111100000000000111000011
1000000000000000011101111
1000000000000000000000011
1111000000000000000101011
1100000000010100000000011
1000000000000000110000011
1000000000N00000110101011
1100000111010101011101111
1111011111110101110111101
1111111111111111111111111
