SO ./texter/wall/1.xpm
NO ./texter/wall/2.xpm
WE ./texter/wall/3.xpm
EA ./texter/wall/4.xpm
 
F 220,100,0
C 225,30,0


				1
11111111111111111111111111111
10000000000000000000000000001
10000000111111111111000000001
10000W00000000000001000000001
1000000011111D111110000000001
100000000000000D0000000000001
10000101001000010000000000001
10001000000001000000000000001
11111111111111111111111111111
